################### # # # #
#                 # # # # #
################### # # # #
#   ##               # # #
# # ## ### ## ######## # #
# #    #   ##B        # #
# # ## ############## # #
### ##         ##### # #
###  ########     ## # # #
###        ## ###### # # #
###### ###### ####### # #
###### #####           #
A      #################